11111111111111
10010000000C11
10000111110011
1P0011E0000011
11111111011111
10000000000C11
11111111111111
